tropical = {
	#Grahtwood
	1569 3053 3052
	1519 1520 1521 1522 1524 1525 1526 1527 1528 1529 1530 1531 1532 1533 1534 1535 1538 1541 1542 1545 1546 1548 1547 1555 1556 1557 1558 3056 3057 1559 3055 3054 3051 1553 1560
	1523 1536 1537 1539 1540
	1543 1544 1661 1551 1549 1552 1550 1554

	#Greenshade
	3049 1577 1578 1665 1664 1662 1663 1591 1590 1589 1582 1581 1579 1580 1597 1596 1653 1583 1594 1595 1592 1651
	1573 1572 1571 1570 1667 1576 3048 3050 1574 1575 1674 1599 1600 1648 1647
	1652 1649 1654 1598
	1587 1588 1584 1585 1586
	1655 1656 1657 1593

	#Malabal Tor
	1643 1635 1642 1641 1639
	1650 1645 1640
	1566 1565 1568 1567 1603 1601 1602 1630 1629 1633 1631 1632 1628 1634 1636
	1646
	1644

	#Northern Valenwood
	1618 1617 1615 1616
	1605 1604 1606 1625 1627 1622 1624 1626 1638 1623 1637 1620 1619 1614
}

arid = {
	#Grahtwood
	3047

	#Northern Valenwood
	1612 1611 1613 1609 1621 1608 1607 1562 1561
	1564 1563
	1610
}

arctic = {
	1 2 3 4 5 6 7 8 9 10
}

mild_winter = {
	102 103 104 105 106 107 108 109 110 111 112
	113 114 115 116 117 118 119 120 121 122
}

normal_winter = {
	83 84 85 86 87 88 89 90 91 92 93 94 95 96 97 98 
	100 123 124 125 126 127 128 129 130 131 132 134 135 136 137
	140 141 142 144 143
}

severe_winter = {
	1 2 3 4 5 6 7 8 9 10 11 12 13 14 15 16 17 18 19 20 
	21 22 23 24 25 26 27 28 29 30 31 32 33 34 35 36 37 
	38 39 40 41 42 43 44 45 46 47 48 49 50 51 52 53 54
	55 56 57 58 59 60 61 62 63 64 65 66 67 68 69 70 71
	72 73 74 75 76 77 78 79 80 81 82 99 101 991 992 993 138 139
	
}

impassable = {
	3001 3002 3003 3004 3005 3006 3007 3008 3009 3010 
	3011 3012 3013 3014 3015 3016 3017 3018 3019 3020 
	3021 3022 3023 3024 3025 3026 3027 3028 3029 3030 
	3031 3032 3033 3034 3035 3036 3037 3038 3039 3040 
	3041 3042 3043 3044 3045 3046 
}

mild_monsoon = {
}

normal_monsoon = {
	#Grahtwood
	3047
	1556 1557 
	3056 

	#Northern Valenwood
	1612 1611 1613 1609 1621 1608 1607 1562 1561
	1564 1563
	1605 1610 1606
	1622 1614
	1617 1615 1616
}

severe_monsoon = {
	#Grahtwood
	1569 3053 3052
	1519 1520 1521 1522 1524 1525 1526 1527 1528 1529 1530 1531 1532 1533 1534 1535 1538 1541 1542 1545 1546 1548 1547 1555 1558 3057 1559 3055 3054 3051 1553 1560
	1523 1536 1537 1539 1540
	1543 1544 1661 1551 1549 1552 1550 1554

	#Greenshade
	3049 1577 1578 1665 1664 1662 1663 1591 1590 1589 1582 1581 1579 1580 1597 1596 1653 1583 1594 1595 1592 1651
	1573 1572 1571 1570 1667 1576 3048 3050 1574 1575 1674 1599 1600 1648 1647
	1652 1649 1654 1598
	1587 1588 1584 1585 1586
	1655 1656 1657 1593

	#Malabal Tor
	1643 1635 1642 1641 1639
	1650 1645 1640
	1566 1565 1568 1567 1603 1601 1602 1630 1629 1633 1631 1632 1628 1634 1636
	1646
	1644

	#Northern Valenwood
	1618
	1604 1625 1627 1624 1626 1638 1623 1637 1620 1619
}

equator_y_on_province_image = 656