tropical = {
}

arid = {
}

arctic = {
	1 2 3 4 5 6 7 8 9 10
}

mild_winter = {
}

normal_winter = {
	
}

severe_winter = {
	1 2 3 4 5 6 7 8 9 10 11 12 13 14 15 16 17 18 19 20 
	21 22 23 24 25 26 27 28 29 30 31 32 33 34 35 36 37 
	38 39 40 41 42 43 44
}

impassable = {
	3001 3002 3003 3004 3005 3006 3007 3008 3009 3010 
	3011 3012 3013 3014 3015 3016 3017 3018 3019 3020 
	3021 3022 3023 3024 3025 3026 3027 3028 3029 3030 
	3031 3032 3033 3034 3035 3036 3037 3038 3039 3040 
	3041 3042 3043 3044 3045 3046 
}

mild_monsoon = {
}

normal_monsoon = {
}

severe_monsoon = {
}

equator_y_on_province_image = 656