europe = {
	#Scandinavia
	1 2 3 4 5 6 7 8 9 10 11 12 13 14 15 16 17 18 19 20 21 22 23 24 25 26 27 28 29 30 31
	1930 1981 1982 1983 1984 1985 2752 4113 4114 4123 4124 4141 4142 4143 4144 4145 4146
	4149 4151 4152 4163 4164 4165 4166
	#Baltic Coast
	32 33 34 35 36 37 38 39 40 41 42 43 767 770 1834 1841 1842 1935
	#Germany
	44 45 46 47 48 49 50 51 52 53 54 55 56 57 58 59 60 61 62 63 64 65 66 67 68 69 70 71
	72 73 74 75 76 77 78 79 80 81 82 83 84 85 86 128 129 130 131 132 133 134 165 166 1757
	1758 1759 1760 1761 1762 1763 1769 1770 1771 1772 1775 1857 1858 1863 1867 1868 1869
	1870 1871 1872 1873 1874 1876 1878 1880 1931 2955 2956 2957 2964
	2965 2966 2967 2968 2969 2970 2971 2972 2973 2975 2993 2994 2995 2996 
	4237 4238
	#Lowlands 
	87 88 89 90 91 92 93 94 95 96 97 98 99 100 1742 1743 1744 1865 1866 2974 4381 4382 4383
	#Italy
	101 102 103 104 105 106 107 108 109 110 111 112 113 114 115 116 117 118 119 120 121
	122 123 124 125 126 127 1774 1862 1875 1933 1934
	2976 2977 2978 2979 2980 2981 2982 2983 2984 2985 2986 2992
	#Balkans & South Eastern Europe
	135 136 137 138 139 140 141 142 143 144 145 146 147 148 149 150 151 152 153 154 155
	156 157 158 159 160 161 162 163 164 1756 1764 1765 1766 1767 1768 1826 1827 1828 1831
	1864 1951 1952 1953 1954 2348 2746 2750 1318 2998 3000 3001 3002 4125 4126 4127 4128 
	4173 4174 4175 4176 4236 4239 4240
	#Anatolia
	4307 4308 4309 4310 4311 4312 4313 4314 4315
	#Caucasus
	4301 4303 4306
	#France
	167 168 169 170 171 172 173 174 175 176 177 178 179 180 181 182 183 184 185 186 187
	188 189 190 191 192 193 194 195 196 197 198 199 200 201 202 203 204 205 1877 1879 2753 2991
	4384 4385 4386 4387 4388 4389 4390 4391 4392
	#Iberia
	206 207 208 209 210 211 212 213 214 215 216 217 218 219 220 221 222 223 224 225 226
	227 228 229 230 231 232 333 1745 1746 1747 1748 1749 1750 1851 2751 2754 2755
	2987 2988 2989 2990 4150
	4546 4547 4548 4549 4550 4551 4552 4553 4554 4555 4556 4557 4558 4559 4560 4565
	#British isles
	233 234 235 236 237 238 239 240 241 242 243 244 245 246 247 248 249 250 251 252 253
	1860 1861 4118 4119 4120 4121 4130 4361 4362 4363 4364 4365 4366 4367 4368 4369 4370
	4371 4372 4373 4374 4375 4376 4377 4378 4379 4380
	#Poland
	254 255 256 257 258 259 260 261 262 263 264 265 266 267 268 269 270 271 272 273 274
	275 276 277 278 279 280 281 1859 1936 1937 1938 1939 1940 1941 1942 1943 1944 1945 2405 2424
	2958 2959 2960 2961 2962 2963 2997
	#Russia
	282 283 284 285 286 287 288 289 290 291 292 293 294 295 296 297 298 299 300 301 302
	303 304 305 306 307 308 309 310 311 312 313 314 315 1752 1753 1754 1755 1776 1777 1778
	1955 1956 1957 1958 1959 1960 1961 1962 1963 1964 1965 1974
	475 1972 473 464 425 463 462 1856 468 466 1971 467 771 4115 4116 4117 4122 4129 4147 4148
	4241 4242 4243 4244 4245 4246 4247 4248 4249 4250 4251 4252 4253 4254 4255
	4256 4257 4258 4259 4260 4261 4262 4263 4264 4265 4266 4267
	#Russian new provinces
	2406 2407 2408 2409 2410 2411 2412 2413 2414 2415 2416 2417 2418 2419 2420 2421 2422 2423 2425 2447 2749 4178
	#Turkey
	316 317 318 319 320 321 322 323 324 325 326 327 328 329 330 331 332 1846 1848	
	2296 2297 2298 2299 2300 2301 2302 2303 2304 2305
	#Pre-siberia:
	1078 1080 1780 1966 2441 2444 2427 
	#Atlantic islands
	366 367 368 369 370 371 372 373 374 375 376 1978 1979
	#More bits of Russia
	1077 1079 1081 1082 1083 423
	#Europe Additions MN:
	4110 4111 4112
	#Island
	1247
	#More bits of Greece
	1773 1853 3003
	#Persia changes
	422 2195 2196 2197 2198 2199 2201 2203 2204 2208 
	# More PLC
	4523 4524 4525 4526 4527 4528 4529 4530 4531 4532 4533 4534 4535 4536 4537 4538 4539 4540 4541 4542 4543 4544 4545
	
	# New Impassables
	4153 4154 4155 4156 4157 4159 4160 4161 4162
	
	1323 #Crimea Trade Node
	1320 #Constantinople Tradenode
	1297 #Genoa
	1926 #Baltic
	1652 #WhiteSea
	1293 #Sevilla
	1276 #Bourdaux
	1281 #North Sea
	1308 #Venice
}

}