#FOR REFERENCE EUROPE IS LEFT DELETE WHEN DONE
europe = {
	#Scandinavia
	1 2 3 4 5 6 7 8 9 10 11 12 13 14 15 16 17 18 19 20 21 22 23 24 25 26 27 28 29 30 31
	1930 1981 1982 1983 1984 1985 2752 4113 4114 4123 4124 4141 4142 4143 4144 4145 4146
	4149 4151 4152 4163 4164 4165 4166
	#Baltic Coast
	32 33 34 35 36 37 38 39 40 41 42 43 767 770 1834 1841 1842 1935
	#Germany
	44 45 46 47 48 49 50 51 52 53 54 55 56 57 58 59 60 61 62 63 64 65 66 67 68 69 70 71
	72 73 74 75 76 77 78 79 80 81 82 83 84 85 86 128 129 130 131 132 133 134 165 166 1757
	1758 1759 1760 1761 1762 1763 1769 1770 1771 1772 1775 1857 1858 1863 1867 1868 1869
	1870 1871 1872 1873 1874 1876 1878 1880 1931 2955 2956 2957 2964
	2965 2966 2967 2968 2969 2970 2971 2972 2973 2975 2993 2994 2995 2996 
	4237 4238
	#Lowlands 
	87 88 89 90 91 92 93 94 95 96 97 98 99 100 1742 1743 1744 1865 1866 2974 4381 4382 4383
	#Italy
	101 102 103 104 105 106 107 108 109 110 111 112 113 114 115 116 117 118 119 120 121
	122 123 124 125 126 127 1774 1862 1875 1933 1934
	2976 2977 2978 2979 2980 2981 2982 2983 2984 2985 2986 2992
	#Balkans & South Eastern Europe
	135 136 137 138 139 140 141 142 143 144 145 146 147 148 149 150 151 152 153 154 155
	156 157 158 159 160 161 162 163 164 1756 1764 1765 1766 1767 1768 1826 1827 1828 1831
	1864 1951 1952 1953 1954 2348 2746 2750 1318 2998 3000 3001 3002 4125 4126 4127 4128 
	4173 4174 4175 4176 4236 4239 4240
	#Anatolia
	4307 4308 4309 4310 4311 4312 4313 4314 4315
	#Caucasus
	4301 4303 4306
	#France
	167 168 169 170 171 172 173 174 175 176 177 178 179 180 181 182 183 184 185 186 187
	188 189 190 191 192 193 194 195 196 197 198 199 200 201 202 203 204 205 1877 1879 2753 2991
	4384 4385 4386 4387 4388 4389 4390 4391 4392
	#Iberia
	206 207 208 209 210 211 212 213 214 215 216 217 218 219 220 221 222 223 224 225 226
	227 228 229 230 231 232 333 1745 1746 1747 1748 1749 1750 1851 2751 2754 2755
	2987 2988 2989 2990 4150
	4546 4547 4548 4549 4550 4551 4552 4553 4554 4555 4556 4557 4558 4559 4560 4565
	#British isles
	233 234 235 236 237 238 239 240 241 242 243 244 245 246 247 248 249 250 251 252 253
	1860 1861 4118 4119 4120 4121 4130 4361 4362 4363 4364 4365 4366 4367 4368 4369 4370
	4371 4372 4373 4374 4375 4376 4377 4378 4379 4380
	#Poland
	254 255 256 257 258 259 260 261 262 263 264 265 266 267 268 269 270 271 272 273 274
	275 276 277 278 279 280 281 1859 1936 1937 1938 1939 1940 1941 1942 1943 1944 1945 2405 2424
	2958 2959 2960 2961 2962 2963 2997
	#Russia
	282 283 284 285 286 287 288 289 290 291 292 293 294 295 296 297 298 299 300 301 302
	303 304 305 306 307 308 309 310 311 312 313 314 315 1752 1753 1754 1755 1776 1777 1778
	1955 1956 1957 1958 1959 1960 1961 1962 1963 1964 1965 1974
	475 1972 473 464 425 463 462 1856 468 466 1971 467 771 4115 4116 4117 4122 4129 4147 4148
	4241 4242 4243 4244 4245 4246 4247 4248 4249 4250 4251 4252 4253 4254 4255
	4256 4257 4258 4259 4260 4261 4262 4263 4264 4265 4266 4267
	#Russian new provinces
	2406 2407 2408 2409 2410 2411 2412 2413 2414 2415 2416 2417 2418 2419 2420 2421 2422 2423 2425 2447 2749 4178
	#Turkey
	316 317 318 319 320 321 322 323 324 325 326 327 328 329 330 331 332 1846 1848	
	2296 2297 2298 2299 2300 2301 2302 2303 2304 2305
	#Pre-siberia:
	1078 1080 1780 1966 2441 2444 2427 
	#Atlantic islands
	366 367 368 369 370 371 372 373 374 375 376 1978 1979
	#More bits of Russia
	1077 1079 1081 1082 1083 423
	#Europe Additions MN:
	4110 4111 4112
	#Island
	1247
	#More bits of Greece
	1773 1853 3003
	#Persia changes
	422 2195 2196 2197 2198 2199 2201 2203 2204 2208 
	# More PLC
	4523 4524 4525 4526 4527 4528 4529 4530 4531 4532 4533 4534 4535 4536 4537 4538 4539 4540 4541 4542 4543 4544 4545
	
	# New Impassables
	4153 4154 4155 4156 4157 4159 4160 4161 4162
	
	1323 #Crimea Trade Node
	1320 #Constantinople Tradenode
	1297 #Genoa
	1926 #Baltic
	1652 #WhiteSea
	1293 #Sevilla
	1276 #Bourdaux
	1281 #North Sea
	1308 #Venice
}

tamriel = {
	#Valenwood
	1519 1520 1521 1522 1523 1524 1525 1526 1527 1528 1529 1530 1531 1532 1533 1534 1535 1536 1537 1538 1539
	1540 1541 1542 1543 1544 1545 1546 1547 1548 1549 1550 1551 1552 1553 1554 1555 1556 1557 1558 1559
	1560 1561 1562 1563 1564 1565 1566 1567 1568 1569 1570 1571 1572 1573 1574 1575 1576 1577 1578 1579
	1580 1581 1582 1583 1584 1585 1586 1587 1588 1589 1590 1591 1592 1593 1594 1595 1596 1597 1598 1599
	1600 1601 1602 1603 1604 1605 1606 1607 1608 1609 1610 1611 1612 1613 1614 1615 1616 1617 1618 1619
	1620 1621 1622 1623 1624 1625 1626 1627 1628 1629 1630 1631 1632 1633 1634 1635 1636 1637 1638 1639
	1640 1641 1642 1643 1644 1645 1646 1647 1648 1649 1650 1651 1652 1653 1654 1655 1656 1657
	3047 3048 3049 3050 3051 3052 3053 3054 3055 3056 3057
	
	#High Rock
	
	#Elsweyr
	
	#Summerset
	
	#Black Marsh
	
	#Hammerfell
	
	#Cyrodill
	171 191 586
	660	661	662	663	664	665	666	667	668	669	670	671	672	673	674	675	676	677	678	679
	680 681	682	683	684	685	686	687	688	689	690	691	692	693	694	695	696	697	698	699
	700	701	702	703	704	705	706	707	708	709	710	711	712	713	714	715	716	717	718	719
	720	721	722	723	724	725	726	727	728	729	730	731	732	733	734	735	736	737	738	739
	740	741	742	743	744	745	746	747	748	749	750	751	752	753	754	755	756	757	758	759
	760	761	762	763	764	765	766	767	768	769	770	771	772	773	774	775	776	777	778	779
	780	781	782	783	784	785	786	787	788	789	790	791	792	793	794	795	796	797	798	799
	800	801	802	803	804	805	806	807	808	809	810	811	812	813	814	815	816	817	818	819
	820	821	822	823	824	825	826	827	828	829	830	831	832	833	834	835	836	837	838	839
	840	841	842	843	844	845	846	847	848	849	850	851	852	853	854	855	856	857	858	859
	860	861	862	863	864	865	866	867	868	869	870	871	872	873	874	875	876	877	878	879
	880	881	882	883	884	885	886	887	888	889	890	891	892	893	894	895	896	897	898	899
	900	901	902	903	904	905	906	907	908	909	910	911	912	913	914	915	916	917	918	919
	920	921	922	923	924	925	926	927	928	929	930	931	932	933	934	935	936	937	938	939
	940	941	942	943	944	945	946	947	948	949	950	951	952	953	954	955	956	957	958	959
	960	961	962	963	964	965
	4269 4270
	
	#Skyrim
	14 15 16 17 18 19 20 21 22 23 24 25 26 27 28 29 30 31 32 33 34 35 36 37 38 39
	40 41 42 43 44 45 46 47 48 49 50 51 52 53 54 55 56 57 58 59 60 61 62 63 64 65 66 67 68 69
	70 71 72 73 74 75 76 77 78 79 80 81 82 83 84 85 86 87 88 89 90 91 92 93 94 95 96 97 98 99
	100 101 102 103 104 105 106 107 108 109 110 111 112 113 114 115 116 117 118 119
	120 121 122 123 124 125 126 127 128 129 130 131 132 133 134 135 136 137 138 139
	140 141 142 143 144
	#Skyrim Wasteland
	3002 3003 3004 3005 3006 3007 3008 3009
	
	#Morrowind
	
	#WASTELAND that isnt marked on map fsr and im too lazy to fix so its here now
	3045
	########################
	# DONT FORGET WASTELANDS
	########################

}

atmora = {
	#Atmora
	
	
	#Roscrea
}

yokuda = {
	#Yokuda
	
}

thras = {
	#Thras
	
}

akavir = {
	#SUBCONTINENT NAMES HERE
	
}

pyandonea = {
	#Pyandonea
	
}

cathnoquey = {
	#Cathnoquey
	
}